xxxxxxxxxxxxxxxxxxxxxxxxxxxxxxx
xO                           Ox
x x x x x x x x x x x x x x x x
x                             x
x x x x x x x x x x x x x x x x
x                             x
x x x x x x x x x x x x x x x x
x                             x
x x x x x x x x x x x x x x x x
x                             x
x x x x x x x x x x x x x x x x
x                             x
x x x x x x x x x x x x x x x x
x                             x
x x x x x x x x x x x x x x x x
x                             x
x x x x x x x x x x x x x x x x
xO                           0x
xxxxxxxxxxxxxxxxxxxxxxxxxxxxxxx

Map prédéfinie comme ca
Taille map max 32*32 avec murs extérieurs soit 30*30 de déplacement
Cédric Kélian;