###################
#O               0#
# x x x x x x x x #
#                 #
# x x x x x x x x #
#                 #
# x x x x x x x x #
#                 #
# x x x x x x x x #
#                 #
# x x x x x x x x #
#                 #
# x x x x x x x x #
#                 #
# x x x x x x x x #
#                 #
# x x x x x x x x #
#0               0#
###################