###################
#P               I#
# x x x x x x x x #
#                 #
# x x x x x x x x #
#                 #
# x x x x x x x x #
#                 #
# x x x x x x x x #
#                 #
# x x x x x x x x #
#                 #
# x x x x x x x x #
#                 #
# x x x x x x x x #
#                 #
# x x x x x x x x #
#I               I#
###################